EA ./textures/4wall.png
SO ./textures/2wall.png
NO ./textures/1wall.png
WE ./textures/3wall.png
F 79, 121, 66
C 137, 207, 240
11111111111111111111
10000010000000000001
10000010000000000001
10000010000000111101
10000000000000000101
10100010000000100101
10111111111100100101
10000000000100100001
10000000W00100110001
10000000000100010001
10011111100111110001
10010000000000000001
10011100001111111001
10010000001000000001
11111111111111111111